1111111111111111111111111
1E0P0C0000E001CCC0000C001
10000010001100CC0000C0001
1011111C01111010100000001
10100010000111100000C0001
100010C01100CC0C010000001
1000000C0C0C0C0C00CCCC001
10C010C01100CC0C01000C001
10C010C01100CC0C010C00001
10C010C01100CC0C01000C001
10C010C01100CC0C0100000C1
10C010C0CC00CC0C01000C001
1111111111111111111111111